...........
..##.#.####
.....###..#
#.........#
#......#..#
.....###..#
..#..#....#
....##.#.##
.#@.....##
.#.....##
.#######