...........
..##.#.####
.....###..#
#.........#
#......#..#
.....###..#
..####@...#
.......#.##
.......##
.......##
.#######